10 7 400
0 0 0 0 0 0 0 0 0 0 0 0 0 0 0 0 0 0 0 0 0
0 1 1 1 1 1 0 0 0 0 0 0 0 0 0 1 1 1 1 1 0
0 1 1 1 1 1 0 0 0 0 0 0 0 0 0 1 1 1 1 1 0
0 1 1 1 1 1 0 0 0 0 0 0 0 0 0 1 1 1 1 1 0
0 1 1 1 1 1 0 0 0 0 0 0 0 0 0 1 1 1 1 1 0
0 1 1 1 1 1 0 0 0 0 0 0 0 0 0 1 1 1 1 1 0
0 1 1 1 1 1 0 0 0 0 0 0 0 0 0 1 1 1 1 1 0
0 1 1 1 1 1 0 0 0 0 0 0 0 0 0 1 1 1 1 1 0 
0 1 1 1 1 1 0 0 0 0 0 0 0 0 0 1 1 1 1 1 0
0 1 1 1 1 1 0 0 0 0 0 0 0 0 0 1 1 1 1 1 0
0 1 1 1 1 1 0 0 0 0 0 0 0 0 0 1 1 1 1 1 0
0 0 0 0 0 0 0 0 0 0 0 0 0 0 0 0 0 0 0 0 0
0 0 0 0 0 0 0 0 0 0 0 0 0 0 0 0 0 0 0 0 0
0 0 0 0 0 0 0 0 0 0 0 0 0 0 0 0 0 0 0 0 0
0 0 0 0 0 0 0 0 0 0 0 0 0 0 0 0 0 0 0 0 0